═════╦.........
.....║.........
.....║.........
.....║.........
.....║.........
.....║.........
.....█.........
...............
...............
...............
