.....╔══════╗...........
═███╗║......║......█....
.╔═█╬╝..╔═══╣...╗..║....
.║.█║...║...╚═╦═╝╚╦╝....
.╚╦═█═══╣.....║...║.....
..╚══███║.....╚═══╝.....
